T------------------7
| U             N  |
|  T--------  ---7 | 
|  |             | |
|  |          T  | |
|  |   T--J   |  | | 
|  | A |      |C   |
|  L---J      L--7 |
|    Z       P   | |
|  T---   -------J         
|  |k     M          
|  L   ---------   |
|                  |
|M               X |
L------------------J
